You've awoken. A blinding light pierces your eyes as they attempt to adjust to your surroundings. You lay on a soft shore of a white-sanded beach, temporarily incapacitated but still conscious. After your eyes adjust, your arms and legs come to. You feel the powdered sand beneath your body, feeling has come back to you.

Mysteria
An Interactive Fiction by decca
Release 1 / Serial number 170209 / Inform 7 build 6M62 (I6/v6.33 lib 6/12N) SD

Shore (in the sand)
You remain lying down on the soft sands of the mysterious beach. You don't know where you are. You don't know who you are.

>enter snd
You can't see any such thing.

>enter sand
But you're already in the sand.

>stand up
As you stand, you finally look around only to realize you are surrounded by clear blue waters. You have nothing on you but grey, loose-fitted linen clothes on your back. For an unknown reason, you feel a sense of calmness stir in the air. However it doesn't take long before that tranquility turns into worrisome. Among all the questions that float around your head, you lock on to only one thing...survival.

Island

* * *

You've awoken. A blinding light pierces your eyes as they attempt to adjust to your surroundings. You lay on a soft shore of a white-sanded beach, temporarily incapacitated but still conscious. After your eyes adjust, your arms and legs come to. You feel the powdered sand beneath your body, feeling has come back to you.

Mysteria
An Interactive Fiction by decca
Release 1 / Serial number 170209 / Inform 7 build 6M62 (I6/v6.33 lib 6/12N) SD

Shore (in the sand)
You remain lying down on the soft sands of the mysterious beach. You don't know where you are. You don't know who you are.

>exit
As you stand, you finally look around only to realize you are surrounded by clear blue waters. You have nothing on you but grey, loose-fitted linen clothes on your back. For an unknown reason, you feel a sense of calmness stir in the air. However it doesn't take long before that tranquility turns into worrisome. Among all the questions that float around your head, you lock on to only one thing...survival.

Island

>stand
But you aren't in anything at the moment.

>enter
You must supply a noun.

>enter sand
You can't see any such thing.

>leave island
I only understood you as far as wanting to leave.

* * *

You've awoken. A blinding light pierces your eyes as they attempt to adjust to your surroundings. You lay on a soft shore of a white-sanded beach, temporarily incapacitated but still conscious. After your eyes adjust, your arms and legs come to. You feel the powdered sand beneath your body, feeling has come back to you.

Mysteria
An Interactive Fiction by decca
Release 1 / Serial number 170209 / Inform 7 build 6M62 (I6/v6.33 lib 6/12N) SD

Shore (in the sand)
You remain lying down on the soft sands of the mysterious beach. You don't know where you are. You don't know who you are.

>get up
As you stand, you finally look around only to realize you are surrounded by clear blue waters. You have nothing on you but grey, loose-fitted linen clothes on your back. For an unknown reason, you feel a sense of calmness stir in the air. However it doesn't take long before that tranquility turns into worrisome. Among all the questions that float around your head, you lock on to only one thing. . .survival.

 You see a dimly lit cave on the north side of the shore.

Island
You are now on the island. . .there's no looking back anymore.

>look around
You can't see any such thing.

>go to cave
You can't see any such thing.

>walk north
Cave
As you approach the cave ahead, you feel an eerie aura surrounding it. It seems like there is no light there.

You notice a torch beside the cave entrance. You feel luck is on your side.

You can also see an ember here.

>grab torch
That's not a verb I recognise.

>take torch
You grab the torch.

>take ember
The ember feels warm in your hands. You seem to be resistant to fire.

>x
What do you want to examine?

>torch
The torch feels old and partially burnt like it had been used before. Maybe it can be lit?

>light torch
This dangerous act would achieve little.

* * *

You've awoken. A blinding light pierces your eyes as they attempt to adjust to your surroundings. You lay on a soft shore of a white-sanded beach, temporarily incapacitated but still conscious. After your eyes adjust, your arms and legs come to. You feel the powdered sand beneath your body, feeling has come back to you.

Mysteria
An Interactive Fiction by decca
Release 1 / Serial number 170209 / Inform 7 build 6M62 (I6/v6.33 lib 6/12N) SD

Shore (in the sand)
You remain lying down on the soft sands of the mysterious beach. You don't know where you are. You don't know who you are.

>hellp
That's not a verb I recognise.

>hello
That's not a verb I recognise.

>rise
That's not a verb I recognise.

>stand
As you stand, you finally look around only to realize you are surrounded by clear blue waters. You have nothing on you but grey, loose-fitted linen clothes on your back. For an unknown reason, you feel a sense of calmness stir in the air. However it doesn't take long before that tranquility turns into worrisome. Among all the questions that float around your head, you lock on to only one thing. . .survival.

 You see a dimly lit cave on the north side of the shore.

Island
You are now on the island. . .there's no looking back anymore.

>walk north
Cave entrance
The entrance to the cave is bleak and does not garner hope for what may be inside. However you notice a torch beside the cave entrance. You feel like luck is on your side.

A shimmering ember grasps its last dying breaths. Perhaps it may still be of use.

>take torch
You grab the torch.

>take ember
A deep fire resonates in your hand.

>light torch
Torch remains unlit. You must use your new flame.

>light torch with flame
You can't see any such thing.

>light torch with ember
The torch is lit.

The Cave's archaic interior becomes visible.

Inside the Cave
A faint light eminating from a distance pulls you through the inner parts of the cave. As you journey carefully through, you hear inaudible whispers echoing through the darkness. 

 You are at the point of no return. You stand before a mysterious light illuminating from a small stone.

>take stone
You feel an ominous yet vibrant aura around you as you grab the stone.

>x stone
A mystic power resonates deep within this stone.

* * *

You've awoken. A blinding light pierces your eyes as they attempt to adjust to your surroundings. You lay on a soft shore of a white-sanded beach, temporarily incapacitated but still conscious. After your eyes adjust, your arms and legs come to. You feel the powdered sand beneath your body, feeling has come back to you.

Mysteria
An Interactive Fiction by decca
Release 1 / Serial number 170209 / Inform 7 build 6M62 (I6/v6.33 lib 6/12N) SD

Shore (in the sand)
You remain lying down on the soft sands of the mysterious beach. You don't know where you are. You don't know who you are.

>lie down
That's not a verb I recognise.

>lay down
That's not a verb I recognise.

>get up
But you aren't in anything at the moment.

* * *

You've awoken. A blinding light pierces your eyes as they attempt to adjust to your surroundings. You lay on a soft shore of a white-sanded beach, temporarily incapacitated but still conscious. After your eyes adjust, your arms and legs come to. You feel the powdered sand beneath your body, feeling has come back to you.

Mysteria
An Interactive Fiction by decca
Release 1 / Serial number 170209 / Inform 7 build 6M62 (I6/v6.33 lib 6/12N) SD

Shore (in the sand)
You remain lying down on the soft sands of the mysterious beach. You don't know where you are. You don't know who you are.

>n
You would have to get out of the sand first.

>stand
As you stand, you finally look around only to realize you are surrounded by clear blue waters. You have nothing on you but grey, loose-fitted linen clothes on your back. For an unknown reason, you feel a sense of calmness stir in the air. However it doesn't take long before that tranquility turns into worrisome. Among all the questions that float around your head, you lock on to only one thing. . .survival.

 You see a dimly lit cave on the north side of the shore.

Island
You are now on the island. . .there's no looking back anymore.

>n
Cave
As you approach the cave ahead, you feel an eerie aura surrounding it. It seems like there is no light there.

You notice a torch beside the cave entrance. You feel luck is on your side.

You can also see an ember here.

>north
You can't go that way.

* * *

>n
Cave
As you approach the cave ahead, you feel an eerie aura surrounding it. It seems like there is no light there.

You notice a torch beside the cave entrance. You feel luck is on your side.

You can also see an ember here.

>take torch
You grab the torch.

>light torch
This dangerous act would achieve little.

* * *

You've awoken. A blinding light pierces your eyes as they attempt to adjust to your surroundings. You lay on a soft shore of a white-sanded beach, temporarily incapacitated but still conscious. After your eyes adjust, your arms and legs come to. You feel the powdered sand beneath your body, feeling has come back to you.

Mysteria
An Interactive Fiction by decca
Release 1 / Serial number 170209 / Inform 7 build 6M62 (I6/v6.33 lib 6/12N) SD

Shore (in the sand)
You remain lying down on the soft sands of the mysterious beach. You don't know where you are. You don't know who you are.

>s
You would have to get out of the sand first.

>stand
As you stand, you finally look around only to realize you are surrounded by clear blue waters. You have nothing on you but grey, loose-fitted linen clothes on your back. For an unknown reason, you feel a sense of calmness stir in the air. However it doesn't take long before that tranquility turns into worrisome. Among all the questions that float around your head, you lock on to only one thing. . .survival.

 You see a dimly lit cave on the north side of the shore.

Island
You are now on the island. . .there's no looking back anymore.

>n
Cave entrance
The entrance to the cave is bleak and does not garner hope for what may be inside. However you notice a torch beside the cave entrance. You feel like luck is on your side.

You can also see an ember here.

>take ember and torch
ember: A deep fire resonates in your hand.
torch: You grab the torch.

>north
Darkness
You enter the Cave, but without light.

>light torch with ember
The torch is lit.

The Cave's archaic interior becomes visible.

Inside the Cave
You can see a keystone and now the player here.

>look
Inside the Cave
You can see a keystone and now the player here.

* * *

>n
Cave entrance
The entrance to the cave is bleak and does not garner hope for what may be inside. However you notice a torch beside the cave entrance. You feel like luck is on your side.

You can also see an ember here.

>take torch
Taken.

>drop torch
A voice whispers. . . "no light, no passage"
Dropped.

>pick up ember
Taken.

* * *

You've awoken. A blinding light pierces your eyes as they attempt to adjust to your surroundings. You lay on a soft shore of a white-sanded beach, temporarily incapacitated but still conscious. After your eyes adjust, your arms and legs come to. You feel the powdered sand beneath your body, feeling has come back to you.

Mysteria
An Interactive Fiction by decca
Release 1 / Serial number 170209 / Inform 7 build 6M62 (I6/v6.33 lib 6/12N) SD

Shore (in the sand)
You remain lying down on the soft sands of the mysterious beach. You don't know where you are. You don't know who you are.

>stan
That's not a verb I recognise.

>stand
As you stand, you finally look around only to realize you are surrounded by clear blue waters. You have nothing on you but grey, loose-fitted linen clothes on your back. For an unknown reason, you feel a sense of calmness stir in the air. However it doesn't take long before that tranquility turns into worrisome. Among all the questions that float around your head, you lock on to only one thing. . .survival.

 You see a dimly lit cave on the north side of the shore.

Island
You are now on the island. . .there's no looking back anymore.

>north
Cave entrance
The entrance to the cave is bleak and does not garner hope for what may be inside. However you notice a torch beside the cave entrance. You feel like luck is on your side.

A shimmering ember grasps its last dying breaths. Perhaps it may still be of use.

>take ember and torch
ember: A deep fire resonates in your hand.
torch: You grab the torch.

>light torch with ember
The torch is lit.

The Cave's archaic interior becomes visible.

Inside the Cave
A faint light eminating from a distance pulls you through the inner parts of the cave. As you journey carefully through, you hear inaudible whispers echoing through the darkness. 

 You are at the point of no return. You stand before a mysterious light illuminating from a small stone.

>take keystone
You feel an ominous yet vibrant aura around you as you grab the stone.

* * *

You've awoken. A blinding light pierces your eyes as they attempt to adjust to your surroundings. You lay on a soft shore of a white-sanded beach, temporarily incapacitated but still conscious. After your eyes adjust, your arms and legs come to. You feel the powdered sand beneath your body, feeling has come back to you.

Mysteria
An Interactive Fiction by decca
Release 1 / Serial number 170209 / Inform 7 build 6M62 (I6/v6.33 lib 6/12N) SD

Shore (in the sand)
You remain lying down on the soft sands of the mysterious beach. You don't know where you are. You don't know who you are.

>stand
As you stand, you finally look around only to realize you are surrounded by clear blue waters. You have nothing on you but grey, loose-fitted linen clothes on your back. For an unknown reason, you feel a sense of calmness stir in the air. However it doesn't take long before that tranquility turns into worrisome. Among all the questions that float around your head, you lock on to only one thing. . .survival.

 You see a dimly lit cave on the north side of the shore.

Island
You are now on the island. . .there's no looking back anymore.

>e
You can't go that way.

>esat
That's not a verb I recognise.

>walk east
You can't go that way.

* * *

>stand
As you stand, you finally look around only to realize you are surrounded by clear blue waters. You have nothing on you but grey, loose-fitted linen clothes on your back. For an unknown reason, you feel a sense of calmness stir in the air. However it doesn't take long before that tranquility turns into worrisome. Among all the questions that float around your head, you lock on to only one thing. . .survival.

 You see a dimly lit cave on the north side of the shore.

Island
You are now on the island. . .there's no looking back anymore.

>enter sand
As you stand, you finally look around only to realize you are surrounded by clear blue waters. You have nothing on you but grey, loose-fitted linen clothes on your back. For an unknown reason, you feel a sense of calmness stir in the air. However it doesn't take long before that tranquility turns into worrisome. Among all the questions that float around your head, you lock on to only one thing...survival.

* * *

>stand
As you stand, you finally look around only to realize you are surrounded by clear blue waters. You have nothing on you but grey, loose-fitted linen clothes on your back. For an unknown reason, you feel a sense of calmness stir in the air. However it doesn't take long before that tranquility turns into worrisome. Among all the questions that float around your head, you lock on to only one thing. . .survival.

 You see a dimly lit cave on the north side of the shore.

Island
You are now on the island. . .there's no looking back anymore.

>leave
But you aren't in anything at the moment.

>enter
You get into the sand.

>stand up
You get out of the sand.

Island

* * *

>stand
As you stand, you finally look around only to realize you are surrounded by clear blue waters. You have nothing on you but grey, loose-fitted linen clothes on your back. For an unknown reason, you feel a sense of calmness stir in the air. However it doesn't take long before that tranquility turns into worrisome. Among all the questions that float around your head, you lock on to only one thing. . .survival.

 You see a dimly lit cave on the north side of the shore.

Island
You are now on the island. . .there's no looking back anymore.

>look
Island
You are now on the island. . .there's no looking back anymore.

>look back
You can't see any such thing.

>walk north
Darkness
As you approach the cave ahead, you feel an eerie aura surrounding it. It seems like there is no light there.

>take torch
You can't see any such thing.

* * *

>look
Island
You are now on the island. . .there's no looking back anymore.

>walk north
Cave entrance
The entrance to the cave is bleak and does not garner hope for what may be inside. However you notice a torch beside the cave entrance. You feel like luck is on your side.

You can also see an ember here.

>take torch and ember
torch: You grab the torch.
ember: A deep fire resonates in your hand.

>go north
Darkness
You enter the Cave, but without light.

>go back
You can't see any such thing.

>go south
Cave entrance

>use ember on torch
The torch is lit.

The Cave's archaic interior becomes visible.

* * *

>n
Cave entrance
The entrance to the cave is bleak and does not garner hope for what may be inside. However you notice a torch beside the cave entrance. You feel like luck is on your side.

You can also see an ember here.

>n
Darkness
You enter the Cave, but without light.

>take torch
You can't see any such thing.

>south
Cave entrance
The entrance to the cave is bleak and does not garner hope for what may be inside. However you notice a torch beside the cave entrance. You feel like luck is on your side.

You can also see an ember here.

>take torch and ember
torch: You grab the torch.
ember: A deep fire resonates in your hand.

>use ember on torch
The torch is lit.

The Cave's archaic interior becomes visible.

>take keystone
You can't see any such thing.

>enter cave
You can't see any such thing.

>walk north
Cave
You can see a keystone and now the player here.

* * *

>n
Cave entrance
The entrance to the cave is bleak and does not garner hope for what may be inside. However you notice a torch beside the cave entrance. You feel like luck is on your side.

You can also see an ember here.

>take ember
The ember feels warm in your hands. You seem to be resistant to fire.

>take torch
You grab the torch.

>burn torch
This dangerous act would achieve little.

>burn
What do you want to burn?

>torch
This dangerous act would achieve little.

>torch
That's not a verb I recognise.

>burn torch
This dangerous act would achieve little.

* * *

>take ember and torch
ember: A deep fire resonates in your hand.
torch: You grab the torch.

>burn torch
Torch remains unlit. You must use your new flame.

* * *

>take ember and torch
ember: A deep fire resonates in your hand.
torch: You grab the torch.

>i
You are carrying:
  a lightable torch
  an ember

>drop torch
A voice whispers. . . no light, no passage
Dropped.

* * *

>n
Cave entrance
The entrance to the cave is bleak and does not garner hope for what may be inside. However you notice a torch beside the cave entrance. You feel like luck is on your side.

You can also see an ember here.

>take torch
You grab the torch.

>drop
(the torch)
A voice whispers. . . no light, no passage
Dropped.

>take torch
Taken.

>x
(the torch)
The torch feels old and partially burnt like it had been used before. Maybe it can be lit?

* * *

>light torch
This dangerous act would achieve little.

>burn torch
This dangerous act would achieve little.

* * *

>light torch
This dangerous act would achieve little.

>drop torch
A voice whispers. . . "no light, no passage"
Dropped.

* * *

>take ember
The ember feels warm in your hands. You seem to be resistant to fire.

>burn
What do you want to burn?

>burn torch
This dangerous act would achieve little.

>i
You are carrying:
  an ember
  a burnable torch

* * *

>take ember
The ember feels warm in your hands. You seem to be resistant to fire.

>light torch
This dangerous act would achieve little.

* * *

>take ember
The ember feels warm in your hands. You seem to be resistant to fire.

>light torch with ember
The torch is lit.

>burn torch
This dangerous act would achieve little.

* * *

>take torch
You grab the torch.

>x
(the lightable torch)
The torch feels old and partially burnt like it had been used before. Maybe it can be lit?

>drop
(the torch)
Dropped.

>pick up torch
Taken.

>x
(the torch)
The torch feels old and partially burnt like it had been used before. Maybe it can be lit?

>drop
(the torch)
Dropped.

>x
(the torch)
The torch feels old and partially burnt like it had been used before. Maybe it can be lit?

* * *

>n
Cave entrance
The entrance to the cave is bleak and does not garner hope for what may be inside. However you notice a torch beside the cave entrance. You feel like luck is on your side.

You can also see an ember here.

>take torch and ember
lightable torch: You grab the torch.
ember: The ember feels warm in your hands. You seem to be resistant to fire.

>light torch
This dangerous act would achieve little.

>light torch
This dangerous act would achieve little.

* * *

>north
Cave entrance
The entrance to the cave is bleak and does not garner hope for what may be inside. However you notice a torch beside the cave entrance. You feel like luck is on your side.

A shimmering ember grasps its last dying breaths. Perhaps it may still be of use.

>grab ember and torch
That's not a verb I recognise.

>take torch and ember
torch: You grab the torch.
ember: A deep fire resonates in your hand.

>use torch and ember
You can't see any such thing.

>use ember on torch
The torch is lit.

The Cave's archaic interior becomes visible.

>look
Cave entrance

* * *

>north
Cave entrance
The entrance to the cave is bleak and does not garner hope for what may be inside. However you notice a torch beside the cave entrance. You feel like luck is on your side.

A shimmering ember grasps its last dying breaths. Perhaps it may still be of use.

>take ember
A deep fire resonates in your hand.

>take torch
You grab the torch.

>light torch with ember
The torch is lit.

The Cave's archaic interior becomes visible.

Inside the Cave
A faint light eminating from a distance pulls you through the inner parts of the cave. As you journey carefully through, you hear inaudible whispers echoing through the darkness. 

 You are at the point of no return. You stand before a mysterious light illuminating from a small stone.

You can also see a veil and a shadow here.

>take stone
You feel an ominous yet vibrant aura around you as you grab the stone.

You hear faint whispers. . .

"Haste, old friend."

The sound of rocks crumbling echoes throughout your surroundings. The cave begins to cave in.
You suddenly notice a veil east of your direction. . . it seems to lead to the outside.

>open veil
You open the veil.

>walk east
Lagoon
You arrive at the lagoon, narrowly escaping death, you trot forwards and notice remnants that lay beneath.

You remain standing upon heaps of what seems like bones.

You can also see a veil here.

>x bones
Your Keystone reacts to the bones beneath. You hear the several whispers of those before you . . .

    *** You become dizzy and light-headed as you hear a familiar voice.

 "Welcome home. . .patient B22. We thank you for your participation and services."

 Your body falls to the ground weightless and lifeless. You are now one with your ancestors. ***

Would you like to RESTART, RESTORE a saved game, QUIT or UNDO the last command?

* * *

>north
Cave entrance
The entrance to the cave is bleak and does not garner hope for what may be inside. However you notice a torch beside the cave entrance. You feel like luck is on your side.

A shimmering ember grasps its last dying breaths. Perhaps it may still be of use.

>take torch
You grab the torch.

* * *

>take ember
A deep fire resonates in your hand.

>light torch with ember
The torch is lit.

The Cave's archaic interior becomes visible.

Inside the Cave
A faint light eminating from a distance pulls you through the inner parts of the cave. As you journey carefully through, you hear inaudible whispers echoing through the darkness. 

 You are at the point of no return. You stand before a mysterious light illuminating from a small stone.

You can also see a veil and a shadow here.

* * *

>take stone
You feel an ominous yet vibrant aura around you as you grab the stone.

You hear faint whispers. . .

"Haste, old friend."

The sound of rocks crumbling echoes throughout your surroundings. The cave begins to cave in.
You suddenly notice a veil east of your direction. . . it seems to lead to the outside.

>walk east
(first opening the veil)

Lagoon
You can see a veil here.

* * *

>take ember
A deep fire resonates in your hand.

>use ember on torch
The torch is lit.

The Cave's archaic interior becomes visible.

Inside the Cave
A faint light eminating from a distance pulls you through the inner parts of the cave. As you journey carefully through, you hear inaudible whispers echoing through the darkness. 

 You are at the point of no return. You stand before a mysterious light illuminating from a small stone.

You can also see a veil and a shadow here.

>take veil
That's fixed in place.

>open veil
You open the veil.

>exit
But you aren't in anything at the moment.

>x veil
You see nothing special about the veil.

>take stone
You feel an ominous yet vibrant aura around you as you grab the stone.

You hear faint whispers. . .

"Haste, old friend."

The sound of rocks crumbling echoes throughout your surroundings. The cave begins to cave in.
You suddenly notice a veil east of your direction. . . it seems to lead to the outside.

>open veil
That's already open.

>walk east
Lagoon
You arrive at the lagoon, narrowly escaping death, you trot forwards and notice remnants that lay beneath.

You remain standing upon heaps of what seems like bones.

You can also see a veil here.

* * *

>north
Cave entrance
The entrance to the cave is bleak and does not garner hope for what may be inside. However you notice a torch beside the cave entrance. You feel like luck is on your side.

A shimmering ember grasps its last dying breaths. Perhaps it may still be of use.

>take torch and ember
torch: You grab the torch.
ember: A deep fire resonates in your hand.

>burn ember with torch
The torch is lit.

The Cave's archaic interior becomes visible.

Inside the Cave
A faint light eminating from a distance pulls you through the inner parts of the cave. As you journey carefully through, you hear inaudible whispers echoing through the darkness. 

 You are at the point of no return. You stand before a mysterious light illuminating from a small stone.

>take stone
You feel an ominous yet vibrant aura around you as you grab the stone.

* * *

>take torch and ember
torch: You grab the torch.
ember: A deep fire resonates in your hand.

>light torch with ember
The torch is lit.

The Cave's archaic interior becomes visible.

Inside the Cave
You see a veil east of your direction.

A faint light eminating from a distance pulls you through the inner parts of the cave. As you journey carefully through, you hear inaudible whispers echoing through the darkness. 

 You are at the point of no return. You stand before a mysterious light illuminating from a small stone.

You can also see a shadow here.

>look
Cave
As you approach the cave ahead, you feel an eerie aura surrounding it. It seems like there is no light there.

>look
Cave
As you approach the cave ahead, you feel an eerie aura surrounding it. It seems like there is no light there.

>x
What do you want to examine?

>ember
You see nothing special about the ember.

>x torch
The torch feels old and partially burnt like it had been used before. Maybe it can be lit?

>burn
What do you want to burn?

* * *

>light torch with ember
The torch is lit.

The Cave's archaic interior becomes visible.

Inside the Cave
You see a veil east of your direction.

A faint light eminating from a distance pulls you through the inner parts of the cave. As you journey carefully through, you hear inaudible whispers echoing through the darkness. 

 You are at the point of no return. You stand before a mysterious light illuminating from a small stone.

You can also see a shadow here.

>take stone
You feel an ominous yet vibrant aura around you as you grab the stone.

You here faint whispers. . .

Haste, old friend.

>take shadow
You can't see any such thing.

* * *

>light torch with ember
The torch is lit.

The Cave's archaic interior becomes visible.

Inside the Cave
You see a veil east of your direction.

A faint light eminating from a distance pulls you through the inner parts of the cave. As you journey carefully through, you hear inaudible whispers echoing through the darkness. 

 You are at the point of no return. You stand before a mysterious light illuminating from a small stone.

You can also see a shadow here.

>x shadow
You see nothing special about the shadow.

>open veil
You open the veil.

>enter lagoon
You can't see any such thing.

>walk east
Lagoon
You see a veil east of your direction.

>x veil
It looks like it leads to the outside.

* * *

>take torch and ember
torch: You grab the torch.
ember: A deep fire resonates in your hand.

>use ember on torch
The torch is lit.

The Cave's archaic interior becomes visible.

Inside the Cave
A faint light eminating from a distance pulls you through the inner parts of the cave. As you journey carefully through, you hear inaudible whispers echoing through the darkness. 

 You are at the point of no return. You stand before a mysterious light illuminating from a small stone.

You can also see a veil and a shadow here.

>take stone
You feel an ominous yet vibrant aura around you as you grab the stone.

You hear faint whispers. . .

"Haste, old friend."

The sound of rocks crumbling echoes throughout your surroundings. The cave begins to cave in.
You suddenly notice a veil east of your direction. . . it seems to lead to the outside.

>open veil
It seems to be locked.

>open veil with keystone
You unlock the veil.

>walk east
(first opening the veil)

Lagoon
You arrive at the lagoon, narrowly escaping death, you trot forwards and notice remnants that lay beneath.

You remain standing upon heaps of what seems like bones.

You can also see a veil here.

>x bones
Your Keystone reacts to the bones beneath. You hear the several whispers of those before you . . .

    *** You become dizzy and light-headed as you hear a familiar voice.

 "Welcome home. . .patient B22. We thank you for your participation and services."

 Your body falls to the ground weightless and lifeless. You are now one with your ancestors. ***

Would you like to RESTART, RESTORE a saved game, QUIT or UNDO the last command?

* * *

>use ember on torch
The torch is lit.

The Cave's archaic interior becomes visible.

Inside the Cave
A faint light eminating from a distance pulls you through the inner parts of the cave. As you journey carefully through, you hear inaudible whispers echoing through the darkness. 

 You are at the point of no return. You stand before a mysterious light illuminating from a small stone.

You can also see a veil and a shadow here.

>x stone
You see nothing special about the keystone.

>take keystone
Taken.

* * *

>north
Cave entrance
The entrance to the cave is bleak and does not garner hope for what may be inside. However you notice a torch beside the cave entrance. You feel like luck is on your side.

A shimmering ember grasps its last dying breaths. Perhaps it may still be of use.

>x ember
You can't see any such thing.

>darkness
That's not a verb I recognise.

>dark
That's not a verb I recognise.

>see
That's not a verb I recognise.

>light
What do you want to light?

>torch
You can't see any such thing.

>examine
What do you want to examine?

>use ember on torch
You can't see any such thing.

>x
What do you want to examine?

>cave
You can't see any such thing.

* * *

>stand
As you stand, you finally look around only to realize you are surrounded by clear blue waters. You have nothing on you but grey, loose-fitted linen clothes on your back. For an unknown reason, you feel a sense of calmness stir in the air. However it doesn't take long before that tranquility turns into worrisome. Among all the questions that float around your head, you lock on to only one thing. . .survival.

 You see a dimly lit cave on the north side of the shore.

Island
You are now on the island. . .there's no looking back anymore.

>stand up
But you aren't in anything at the moment.

>z
Time passes.

>z
Time passes.

I beg your pardon?

>e
You can't go that way.

* * *

>stand
As you stand, you finally look around only to realize you are surrounded by clear blue waters. You have nothing on you but grey, loose-fitted linen clothes on your back. For an unknown reason, you feel a sense of calmness stir in the air. However it doesn't take long before that tranquility turns into worrisome. Among all the questions that float around your head, you lock on to only one thing. . .survival.

 You see a dimly lit cave on the north side of the shore.

Island
You are now on the island. . .there's no looking back anymore.

>walk north
Cave entrance
The entrance to the cave is bleak and does not garner hope for what may be inside. However you notice a torch beside the cave entrance. You feel like luck is on your side.

You can also see an ember here.

>go to cave
You can't see any such thing.

>go to cave entrance
You can't see any such thing.

* * *

>walk north
Cave entrance
The entrance to the cave is bleak and does not garner hope for what may be inside. However you notice a torch beside the cave entrance. You feel like luck is on your side.

You can also see an ember here.

>take torch
You grab the torch.

* * *

>take ember
The ember feels warm in your hands. You seem to be resistant to fire.

>Use ember on torch
The torch is lit.

The Cave's archaic interior becomes visible.

* * *

>take torch
You grab the torch.

>x
(the torch)
The torch feels old and partially burnt like it had been used before. Maybe it can be lit?

* * *

>take torch and ember
torch: You grab the torch.
ember: A deep fire resonates in your hand.

>use ember on torch
You must supply a noun.

* * *

>take torch and ember
torch: You grab the torch.
ember: A deep fire resonates in your hand.

>use torch on ember
I didn't understand that sentence.

* * *

>take torch and ember
torch: You grab the torch.
ember: A deep fire resonates in your hand.

>user ember on torch
That's not a verb I recognise.

>use ember on torch
The torch is lit.

The Cave's archaic interior becomes visible.

* * *

>walk north
Cave entrance
The entrance to the cave is bleak and does not garner hope for what may be inside. However you notice a torch beside the cave entrance. You feel like luck is on your side.

You can also see an ember here.

>x torch
The torch feels old and partially burnt like it had been used before. Maybe it can be lit?

>walk north
Darkness
You enter the Cave, but without light.

>x ember
You can't see any such thing.

>walk south
Cave entrance
The entrance to the cave is bleak and does not garner hope for what may be inside. However you notice a torch beside the cave entrance. You feel like luck is on your side.

You can also see an ember here.

>take torch
You grab the torch.

* * *

>take ember
A deep fire resonates in your hand.

>x ember
The ember feels warm in your hand. You seem to be resistant to fire.

>walk north
Darkness
You enter the Cave, but without light.

>x torch
It is pitch dark, and you can't see a thing.

>use ember on torch
The torch is lit.

The Cave's archaic interior becomes visible.

Cave
You can see a keystone here.

>go south
Cave entrance

>enter cave
You can't see any such thing.

>walk north
Cave
You can see a keystone here.

* * *

You've awoken. A blinding light pierces your eyes as they attempt to adjust to your surroundings. You lay on a soft shore of a white-sanded beach, temporarily incapacitated but still conscious. After your eyes adjust, your arms and legs come to. You feel the powdered sand beneath your body, feeling has come back to you.

Mysteria
An Interactive Fiction by decca
Release 1 / Serial number 170209 / Inform 7 build 6M62 (I6/v6.33 lib 6/12N) SD

Shore (in the sand)
You remain lying down on the soft sands of the mysterious beach. You don't know where you are. You don't know who you are.

>stand up
You get out of the sand.

Island
You remain lying down on the soft sands of the mysterious beach.  You finally look around only to realize you are surrounded by clear blue waters. You have nothing on you but grey, loose-fitted linen clothes on your back. For an unknown reason, you feel a sense of calmness stir in the air. However it doesn't take long before that tranquility turns into worrisome. Among all the questions that float around your head, you lock on to only one thing...survival.

You can see a sand (empty) here.

>stand
But you aren't in anything at the moment.

>s
You can't go that way.

>stand
But you aren't in anything at the moment.

* * *

You've awoken. A blinding light pierces your eyes as they attempt to adjust to your surroundings. You lay on a soft shore of a white-sanded beach, temporarily incapacitated but still conscious. After your eyes adjust, your arms and legs come to. You feel the powdered sand beneath your body, feeling has come back to you.

Mysteria
An Interactive Fiction by decca
Release 1 / Serial number 170209 / Inform 7 build 6M62 (I6/v6.33 lib 6/12N) SD

Shore (in the sand)
You remain lying down on the soft sands of the mysterious beach. You don't know where you are. You don't know who you are.

>walk
What do you want to walk?

>north
As you approach the cave ahead, you feel an eerie aura surrounding it. It seems like there is no light there.

You must name something more substantial.

* * *

You've awoken. A blinding light pierces your eyes as they attempt to adjust to your surroundings. You lay on a soft shore of a white-sanded beach, temporarily incapacitated but still conscious. After your eyes adjust, your arms and legs come to. You feel the powdered sand beneath your body, feeling has come back to you.

Mysteria
An Interactive Fiction by decca
Release 1 / Serial number 170209 / Inform 7 build 6M62 (I6/v6.33 lib 6/12N) SD

Shore (in the sand)
You remain lying down on the soft sands of the mysterious beach. You don't know where you are. You don't know who you are.

>walk north
As you approach the cave ahead, you feel an eerie aura surrounding it. It seems like there is no light there.

You must name something more substantial.